abandon - 포기하다,단념하다
ability - 능력
accept - 받아들이다,수락하다
acceptable - 받아들일수있는
accidentally - 우연히
accomplish - 수행하다,완성하다
according to - ~에따라,따르면
acknowledge - ~을받았음을알리다,인정하다
at all times - 언제나,내내
a variety of - 다양한(various)
avestedinterest - 기득권
baggage allowance - 수하물,허용량
balance - 잔고,균형
calculate - 계산하다
calculated - 계산된
calculation - 계산
carefor - ~을 돌보다
comprehensive - 포괄적인
damage - 피해,손상
damaged - 손상을입은,파손된
damaging - 손해를끼치는,해로운
damagingly - 피해가되게
deal with - 문제를처리하다,다루다
decide - 결정하다,해결하다
deciding - 결정적인
decision - 결정,결단
decisive - 결정적인
engage in - ~에종사하다,관여하다
eager - 열망하는
eagerly - 간절히,열심히
eagerness - 열심,열망
earn - 획득하다,벌다
faint - 희미한
fallinvalue - 가치가하락하다
fluently - 유창하게,거침없이
found - 설립하다,세우다
foundation - 설립,기반
founder - 설립자,창립자
gap - 틈,격차
gate - 탑승구,입구
gauge - 평가하다,측정하다
get through - ~를통과하다,끝내다
good - 유효한
goods - 상품,물품
habit - 버릇,습관
habitual - 습관적인
idea - 개념,의견
ideal - 이상적인
idealistically - 이상적으로
idealize - 이상화하다
ideally - 더할나위없이,완벽하게
international - 국제적인
internationally - 국제적으로
lasting - 지속적인,오래지속되는
latch - 걸쇠,빗장
magnification - 확대,과장
maintain - 유지하다,주장하다
name - 지명하다,부르다
namely - 다시말하면
obey - 복종하다,따르다
paint - 페인트칠하다,그리다
paper - 서류,신문,평론
per - ~마다
rainfall - 강우,강수량
raise - 올리다,문제를제기하다,모금하다
safekeeping - 보관,보호
season - 계절,시기,양념을치다
seasonal - 계절적인,주기적인
seasoning - 조미료
suitable - 적당한,알맞은
suitably - 적절히,알맞게
tactics - 전술,전략
talk - 이야기하다,담화,토론
wage - 임금
wrongly - 부당하게,잘못하여
abate - 완화시키다,감소하다,
abduct - 유괴하다,납치하다,
accelerate - 가속화하다
access - 접근출입권한
accessible - 접근하기쉬운
accessory - 장신구액세서리
accordingly - 따라서,그러므로
barely - 가까스로,거의~않다
barring - ~이없으면
belong - 속하다
belongings - 소지품
call - 전화하다,부르다
campaign - 운동,캠페인
continual - 연속적인
continually - 계속해서
continuation - 연속,연작
continue - 계속하다
continuity - 연속성
continuous - 연속적인
decline - 쇠퇴하다
declinein - ~있어서의 감소
easily - 쉽게
easiness - 용이함,편리함
easy - 쉬운,간단한
forever - 영원히
gear - 장치,(목적에)맞추다
handle - 다루다,취급하다
haveaninfluenceon - ~에 영향을끼치다
health - 건강,보건
healthful - 건강에좋은
inatimelymanner - 적시에
intricate - 복잡한
irregularly - 불규칙적으로
just enough to - 딱 ~할만큼 충분한
lagbehind - 뒤쳐지다,
lease - 임대하다,임대차(계약)
lecture - 강의,강연
mail - 우편,우편에붙이다
mailing - 우송,우편물
narrow - 좁히다, 좁은
narrow down A to B - A를 B의범위로좁히다
object - 반대하다
objection - 반대
objective - 목적,객관적인
objectively - 객관적으로
oblivious - 깨닫지못하는,알지못하는
parallel - 평행의
qualified - 자격있는,적격의
quality - 품질,자질
randomize - 무작위로 고르다
randomly - 무작위로
rapid - 빠른,급한
rapidly - 빠르게,신속하게
rate - 요금,속도,비율
rating - 평가,견적액,신용도
sale - 판매 - 판매의
spontaneously - 자발적으로
superior - 우수한뛰어난
talented - 재능이있는,유능한
tariff - 관세
trouble - 괴롭히다,걱정시키다,걱정
ultimate - 최후의궁극적인
understand - 이해하다,알다
understandable - 이해할만한
understanding - 이해,협정,이해심많은
uniform - 유니폼
vacancy - 공석,결원
vacant - 공석의,비어있는
vacate - 비우다,떠나다
valor - 용기,용맹
weaken - 약화시키다
weakness - 약점,결점
whole - 전체의
accomplice - 공범자
accord - 일치,조화,합의
account - 설명,계좌
accountable - 설명할수있는,책임이있는
accountably - 설명할수 있도록
acquaint - 알리다,숙지시키다
beneficial - 유익한,이로운
beneficiary - 수익자,수취인
benefit - 이익,수당
broad - 넓은
broaden - 넓히다,확장하다
broadly - 널리,대체로
calm - 고요한,평온한
calmly - 차분하게,조용하게
calmness - 평온,침착
candidate - 후보자
common - 공통의
commonly - 일반적으로
decrease - 줄이다,감소하다
delegate - 위임하다,대표
delegation - 대표단
early - 이른 - 일찍
faction - 당파,파벌
famished - 굶주린
finished product - 완제품
generalization - 일반화
generalize - 개괄하다,종합하다
generally - 일반적으로
graceful - 우아한,품위있는
gracefully - 우아하게,품위있게
handcrafted - 손으로만든
highersalary - 더 높은 월급
identical - 동일한
identifiable - 신원을확인할수있는
identification - 신분증명(서)
identify - 확인하다,동일시하다
identity - 신원
illustrate - 설명하다,예증하다
illustrator - 삽화가
impact - 영향,효과
intuitive - 직관에의한
late - 늦은,늦게
lately - 최근에
lateness - 늦음,지연
latest - 최근의
lessen - 감소시키다,약화시키다
maneuver - 유도하다
negotiation - 협상,교섭
obligate - 의무를지우다,강요하다
reach - 도착하다,연락을취하다
reaction - 반응,태도
satisfaction - 만족
satisfactorily - 만족스럽게,충분히
satisfactory - (요구,목적을)충족시키는
satisfied - 만족한
satisfy - 만족시키다
satisfying - (성취감으로)만족을주는
scrutinize - 면밀히 조사하다
send A to B - A를B에게보내다
sure - 확신하는
takecareof - 돌보다,책임지다
tend - ~하는경향이있다
underconstruction - 공사중인
union - 조직,단체
update - 새롭게하다,갱신하다
verify - 증명하다,입증하다
above all - 무엇보다도
accurate - 정확한
accurately - 정확히
border - 경계선,접하다
capacity - 능력,용적
care - 걱정하다,돌보다
careful - 주의깊은
carefully - 주의깊게
carelessly - 부주의하게
dedicate - 바치다,전념하다
dedicated - 헌신적인
dedication - 헌신
deem - 생각하다,간주하다
degree - 정도,등급
elect - 선출하다
election - 선거선출
eliminate - 제거하다
fare - 교통요금,운임
fill - 채우다,메우다
find out - ~을발견하다
grant - 수여하다,허가하다
honor - 영광,존경하다(=respect)
impair - 악화하다,손상시키다
improvementin - ~에 있어서의 발전
lend - 빌려주다
lender - 빌려주는사람
level - 수준,단계
master - 정통하다,터득하다
need - 필요로하다,필요한것
neediness - 가난,곤궁
needlessly - 불필요하게
needy - 매우 가난한
neuter - 중성,중립의
neutral - 중립적인
neutrality - 중립(상태),중립정책
neutralize - 중립화하다
neutrally - 중립적으로
neutron - 중성자
partial - 부분적인,편파적인
partially - 부분적으로
partition - 분할,구분
partner - 공동경영자,동료
patronize - 단골로삼다,후원하다
permanent - 영구한,불변의
quick - 빠른
quicken - 빠르게하다
quickly - 빠르게
quickness - 민첩,기민
rare - 드문희귀한
salvage - (해난,재산)구조
scent - 향기냄새
search - 찾다,탐색하다
still - 아직도,여전히
technical - 전문적인기술적인
technicality - 전문적사항,전문어
technically - 전문적으로
technician - 기술자,전문가
technique - 기법,기술
technology -과학기술
temporal - 시간의,세속의
temporarily - 일시적으로,임시로
temporary - 일시적인,임시의
unanimous - 만장일치의
valid - 유효한
validation - 확인
view - 보다,관점,견해
weight - 무게,체중
willing - 기꺼이~하는
willingness - 기꺼이하기
accompany - 동반하다
accountant - 회계사
accounting - 회계(학)
acutely - 날카롭게,격렬하게
blend - 혼합하다
budget - 예산,예산을세우다
categorize - 분류하다
category - 부문,유형
claim - 요구하다,요구
concisely - 간결하게
defend - 방어하다,지키다
economic - 경제학의,경제상의
economical - 경제적인,절약이되는
economically - 경제적으로
ecomomics - 경제학
economist - 경제학자
economize - 절약하다
economy - 경제
favor - 호의,친절
favorably - 호의적으로
favorite - 좋아하는
growth - 성장
impart - 알리다,말하다
largely - 주로,대부분
leverage - 지레장치,영향력
license - 면허,허가
lift - 들어올리다
manners - 예절,풍습
marginal - 적은,별로,중요하지않는
marginally - 약간
neglect - 무시하다,소홀히하다
obstruct - 방해하다,막다
occasion - 경우,기회
occasional - 이따금의,가끔의
occasionally - 가끔씩,때때로
on behalf of - ~을 대표하여
pattern - 무늬,모양,양식
pay - 지불하다
payment - 지불,납입
periodic - 주기적인
periodically - 정기적으로
play - 경기하다,연주하다
pronouncement - 공고,선언
recite - 암송하다
resign - 사임하다
resignation - 사직,사임
resigned - 사직한
resignedly - 체념한듯이
seem - ~처럼보이다,~인것같다
select - 선택하다
selection - 선택,선집
specific - 구체적인
specifically - 구체적으로
specification - 설명서
specify - 명시하다
specification of - ~에대한 세부내역
straightly - 곧바로
surface - 표면
sustained - 지속된,한결같은
tenant - 거주자,토지차용자
tire - 피곤하게하다
wellness - 건강함
accost - 가까이가서말을걸다
accrue - (돈,이자등이)붙다
accumulate - 축적하다,모으다
accumulation - 축적,누적
achievement - 업적,성취
adamantly - 단호하게
beaimedat - ~을겨냥하다
block - 방해하다,장애,두절
build - 세우다
builder - 건설자,건축업자
built - in - 붙박이의,장착된
bulk - 용적,부피
cause - 원인이되다,야기하다
certifiable - 보증할수있는
certification - 증명(서)
certified - 공인의,증명된
certify - 보증하다,증명하다
checkin - (호텔,공항에서)수속하다
collaborate - 합작하다
command - 명령하다
construe - 해석하다
declaratory - 선언의
declared - 선언한,공언한
deflate - 수축시키다
emerge - 나타나다
employ - 고용하다
employed - 고용된
employee - 종업원,피고용인
employer - 고용주
employment - 고용,이용
feature - 특징
featured - 특종의,주연의
find - 발견하다,찾다
findings - 조사,결과
grip - 꽉잡다,파악하다
implement - 이행하다,실시하다
inability - 무능,무력
likelihood - 가능성,있음직함
likely - ~할것같은
likeness - 비슷함,닮음
make requests - 요청하다
mark - 표,자국
markedly - 뚜렷하게
measure - 측정하다
obtain - 얻다,획득하다
occupancy - 거주,점유
occupant - 거주자
occupation - 직업
occupy - 차지하다,점유하다
office efficiency - 사무효율
penalty - 벌금,과금
pending - 미결정의,임박한
pessimistically - 비관적으로
probabilistic - 확률적인
possibility - 가능성
probable - 있음직한,가능성있는
probably - 아마도
reason - 이유,이성
reasonable - (값이)과하지않은,적당한,논리적인
remark - 주목하다,말하다
remarkably - 두드러지게,현저하게
represent - 나타내다
representative - 대표자,대리인
seat - 착석시키다,수용하다
sect - 분파,당파
sentence - 형을선고하다
take A into account - A를 고려하다
unused - 쓰지않은,사용치않은
utility - (전기·가스등의)공공시설
utilization - 이용
utilize - 이용하다
utilizer - 이용자
adapt - 적응하다,개조하다
adaptation - 적응,개조
caution - 조심,주의
cautious - 조심성있는,신중한
cautiously - 조심스럽게
chance - 가능성,기회
charge - 부과하다,(금액을)청구하다
commute - 통근하다
defy - 도전하다,반항하다
demand - 요구하다(=request)
demanding - 힘든,까다로운
demandingly - 고되게
dependon - ~의존하다
desirable - 바람직한
efficiency - 능률
efficient - 능률적인,유능한
efficiently - 능률적으로
encase - (상자등에)쌓다,넣다
enormously - 엄청나게
fast - 빠른신속한,빨리
fee - 수수료,요금
finish - 끝내다,마치다
finished - 끝마친,완성된
give out - ~을 배부하다
hard - 어려운
harden - 단단하게하다
hardened - 굳어진,확립된
hardly - 거의~않다
hardness - 단단함,견고
immune - 면역성의
impartial - 공평한
impartiality - 공명정대
impartially - 치우치치않게,공정하게
imply - 암시하다,내포하다
impose - (의무,세금등을)지우다,부과하다
in addition - 게다가,더욱이
in addition to - ~에덧붙여
incidence - 발생(률)
incident - 사건
incidental - 우연히 발생하는
incidentally - 부수적으로,우연히
lax - 느슨한,해이한
leavefor - ~를향해떠나다
makeupfor - ~를보충하다
marriage - 결혼(식)
material - 물질,재료
materialistic - 물질주의적인
norminal - 아주적은,보잘것없는
norminally - 표면상,명목상
notice - 공고,주목
noticeable - 현저한,두드러진
occur - 일어나다생기다(=happen)
odor - 냄새
payincrease - 임금인상
perform - 수행하다
performance - 성과,상연
perishable - 썩기쉬운,개지기쉬운
perish - 죽다,썩어없어지다,소멸하다
raise questioins - 질문하다,의문시하다
receptacle - 용기,두는곳
reception - 환영회,접수처
receptionist - 접수계원
receptiveness - 수용,받아들임
recipient - 수령자
recline - 기대다,의지하다
recognize - 분간하다,알아보다
recommend - 추천하다
set - 맞추다,배치하다,차리다
setting - 경우환경
shake - 흔들다
strictly - 엄밀히,엄격하게
terminate - 끝나다,종결되다
track - 자취,철로
tradition - 전통
transcribe - 베끼다번역하다
unwavering - 동요하지않은,확고한
acquire - 얻다획득하다,
addition - 첨가,부가
additional - 부가적인,추가의
additionally - 덧붙여,게다가
address - 주소,편지를보내다,검토하다
book - 예약하다
characteristic - 특징
chart - 도표
climb - 오르다승진하다
consciously - 의식적으로
credible - 신뢰할수있는
credit - 신용 - 금액을기입하다
creditable - 신용할수있는
delay - 지연,연기하다
derivation - 기원파생
derive - 파생하다,발생하다
electron - 전자
electronic - 전자의
electronically - 전자공학적으로
electronics - 전자공학
encircle - 둘러싸다,에워싸다
finance - 재정재무
financial - 재정상의
financially - 재정적으로
financing - 자금조달
fire - 해고하다
guard - 지키다,수호하다
improve - 개선하다
improvement - 개선,향상
inaugurate - 개시하다,취임시키다
line - 선,타입
mildly - 온화하게
notification - 통보,알림
notify - 알리다,통보하다
novelty - 새로움,신기로움
offer - 제공하다,제안하다
office - 사무소,영업소
omission - 생략,누락
on one's own - 스스로,단독으로
permission - 허가허용
permissive - 허용하는
permit - 허락하다
quiet - 조용한
quietly - 조용하게
quietness - 고요
real - 진짜의진정한
realism - 사실주의
realist - 현실주의자
realistic - 현시주의의사실주의의
realistically - 사실적으로
reality - 현실(성)
realize - 깨닫다,이해하다
record - 기록하다
scarce - 부족한
scarcely - 간신히,거의~않다
shield - 보호하다,감추다
stringently - 엄격하게
take advantage of - ~을이용하다
takesteps - 조치를취하다
unattached - 떨어져있는
unavailable - 이용할수없는
upcoming - 다가오는
valuable - 값비싼,귀중한
valuation - 평가(액)
value - 가치,존중하다,평가하다
with reference to - ~에관련하여
work - 일
workplace - 일터,작업장
act - 행동하다,실행하다
active - 활발한
actively - 활발하게,적극적으로
activeness - 활약
activity - 활동,운동
advance - 진보,승진
advantage - 이점,강점
adversely - 반대로
be applied to - ~에적용되다
check - 수표,조사하다,점검하다
choice - 선택한것,선택
close - 닫다,가까운
closed - 닫힌
close down - 작업,정지
closely - 가까이,면밀하게
closeness - 밀폐,친밀
comply - 응하다,따르다
consequently - 따라서
develop into - ~로 발전하다,전개하다
encourage - 격려하다,촉진하다
encouragement - 격려,장려
encouraging - 힘을북돋아주는,장려하는
except - ~을제외하고
excepting - ~를빼고,~를제외하면
exception - 예외,제외
exceptional - 예외적인
exceptionally - 예외적으로
except for - ~를제외하고
fit - 맞다,적합하다
focus on - ~에집중하다
go shopping - 쇼핑가다
impatient - 성급한,조급한
include - 포함하다
inclusion - 포함,함유
inconsistency - 모순,불일치
list - 목록,목록에기입하다
means - 수단,방법
mediation - 중재
operate - 움직이다
operation - 작용,운영
operational - 기능을다하는,운행가능한
operative - 움직이는,작용하는
operator - (전화국)교환원
place - 배치하다,위치하다
placement - 배치(=staffing)
potentially - 가능성있게,잠재적으로
recent - 최근의
recently - 최근에
redesign - 디자인을 고치다
securable - 확보할수있는
secure - 안정된,보장하다
securely - 안전하게
security - 보안
sensation - 감각,반향
sense - 감각,느낌
shock - 놀라게하다
shop - (가게에서)물건을사다
strongly - 세게,단호히
thorough - 철저한,완전한
thoroughly - 철저하게,완전하게
thoroughness - 완전,철저함
transfer - 옮기다,전학하다
transferable - 이동할수있는
transference - 이동
unbiased - 공평한,선입견이없는
uncertain - 불확실한,미정의
unlimited miles - 무제한 주행거리
upgrade - 품질을 향상시키다,개량하다
widely admired - 널리 칭송받는
worth - 가치가 있는
worth while - 애쓸 가치가있는
worthy - 가치있는
accountfor - 차지하다,~를설명하다,
add, - 더하다,첨가하다
addict - 빠지게하다,열중하다,
advancein - ~에서의진보
advice - 충고,조언
advisable - 타당한,현명한
advise - 충고하다
advisoradviser - 조언자
advisory - 조언하는,자문의
afterwards - 후에,나중에
announce - 알리다,발표하다
announcement - 발표,공고
be associated with - ~와관련되다
boost - 증가시키다
broadknowledge - 폭넓은지식
collate - 대조하다,맞추어보다
concentrate - 집중하다
contributor to - (출판물)등에의기고자
criticize - 비판하다,비난하다
current - 현재의,통용하는
currently - 현재
defective - 불량의흠이있는
delicate - 섬세한
deliver - 운반하다,배송하다
deliverable - 배달가능한
deliverance - 공표,해방
delivery - 배송,배달
dramatic - 희곡의극적인
dramatically - 극적으로
electric - 전기의전자의
electricity - 전력,전기
endurance - 지구력,내구성
engrave - 새기다,장식하다
flow - 흐르다, - 흐름
happily - 행복하게,기꺼이
imperative - 강제적인,필수적인
inconvenience - 불편
increase - 증가하다,늘어나다,
increasing - 늘어나는,증가하는
increasingly - 점점더
incur - 손실을입다,초래하다
indecision - 우유부단
locate - 위치하다,찾다
location - 위치,장소
medic - 의사수련의
medical - 의학의
medically - 의학적으로
medicate - 투약하다
medicinal - 약의,의약의
meet - 만족시키다,부응하다,만나다
moreover - 게다가,더욱이
opponent - 적수,반대자
opportunity - 기회
oppose - 반대하다
opposition - 반대
petition - 청원,탄원
phase - 상,국면
pledge - 서약하다
precisely - 정밀하게
redemption - 상환,회수
refine - 순화하다,정제하다
reflect - 반영하다
relate - 이야기하다,관련짓다
relation - 관계,관련
relative - 친척,상대적인
relatively - 상대적으로,비교적
series - 연속,시리즈
shrink - 움츠러들다,줄어들다
translation - 번역
undoubtedly - 틀림없이
usual - 보통의일상의
usually - 보통,일반적으로
withdraw - 회수하다인출하다
withdrawal - 회수,인출
adequate - 적당한,적절한
adhere - 부착하다,달라붙다
adjust - 조절하다,조정하다
agenda - 의사결정,의제
aggression - 공격,공격성
aggressive - 공격적인
aggressively - 공격적으로
aggressiveness - 공격성
agree - 동의하다
agreement - 일치,협정,계약
ahead - 미리,앞서서
beaware of - ~를알고있다
becapable of - ~를할수있다
busy - 바쁜,통화중인
clarification - 설명,명확화
clarify - 명확히하다
clarity - 명백,명료
clear - 명백한,제거하다,처리하다
clearance - 정리,재고정리
clearly - 뚜렷하게,명료하게
clearness - 명확함
commitment to - ~에의헌신,전념
consider - 고려하다
considerable - 상당한
considerably - 꽤
considerate - 이해심있는
consideration - 고려
constraint - 강제,제약
dedication to - ~에의헌신
delighted - 기뻐하는,즐거워하는
demolish - 폐지하다
digit - 아라비아 숫자
dimension - 치수,넓이
diminish - 줄이다,감소하다
disqualified - 자격을잃은
enroll - 등록하다,기재하다
ensure - 보장하다,확실하게하다
entrance - 입구
entry - 참가,가입
especially - 특히
fascinate - 매혹하다,반하게하다,
fascinating - 매혹적인
fascination - 매혹,매료
force - 힘,세력,강요하다
halt - 멈추다,정지하다
indicate - 가리키다,나타내다
indication - 표시,징후
indicative - 지시하는
least - 최소의,가장적은
mention - 언급하다
message - 메시지,전갈
migration - 이동,이주
mostly - 대부분,대개
nominate - 지명하다,임명하다
nomination - 지명,임명
optimist - 낙관주의자
optimistic - 낙관적인,긍정적인
optimistically - 낙관적으로
optimize - 낙관하다,
phone - 전화기, 전화하다
piece - 부품
process - 과정,공정,처리하다
procession - 행렬,행진
refresh - 새롭게하다,
refreshment - 가벼운음식물,다과
solicit - 간청하다
transmit - 보내다,전하다,
visit - 방문하다
adopt - 채택하다
agree with - ~에동의하다,일치하다
aim - 목적,의도,목표로삼다
alike - 마찬가지로,똑같이
alliance - 동맹,연합
becognizant of - ~을인식하고있다
barrow - 빌리다
combination - 결합,조합
combined - 결합된
compensate - 보상하다
compete - 경쟁하다
competition - 시합,경쟁
competitive - 경쟁적인,가격이알맞은
competitor - 경쟁자
deprive - 빼앗다,박탈하다
deride - 비웃다,조롱하다
derision - 비웃음,조소
enclosed - 동봉된
enclosure - 둘러쌈,동봉된것
enclose - 에워싸다,동봉하다
enhance - 높이다,강화하다
enter - 들어가다
envelope - 봉투
envelopment - 봉함,포장지
eventually - 결국,드디어
exposure to - ~에의 노출
fiscalyear - 회계연도
focus - 중점을두다
forbidden - 금지된
forecast - 예측,예보
heavily - 심하게,몹시
heaviness - 무거움,무게
heavy - 무거운
house - 수용하다
inadvance - 미리,사전에
inclination - 경향,기질
incline - 마음이 내키게하다
indulge - 빠지다,탐닉하다
ineptitude - 부적당
inside - 안쪽의,내부의
listen to - ~을듣다
normal - 표준의
normalcy - 정상상태
normality - 정상상태
normally - 보통
option - 선택권,선택
perfect - 완벽한
perfection - 완전,완성
perfectly - 완전하게,더할나위없이
pioneer - 개척자
plan - 계획,계획하다,
plate - 접시,간판
precede - 앞서다
proficient - 숙련된,능숙한
recover - 회복하다,되찾다
refuse - 거절하다,거부하다
regard - 여기다,간주하다
regarding - ~에관해서
regardless - 개의치않고
regardless of - ~에상관없이
regret - 유감,유감으로생각하다
regrettably - 유감스럽게
settlement - 확정,결정
shape - 모양,형태
sheet - 종이시트
solve - 해결하다
sophisticate - 세련되게하다
sophisticated - 세련된,정교한
sophistication - 세련미,정교함
tight - 단단한
tightly - 단단히,팽팽하게,꽉
tightness - 견고,단단함
transpire - 일어나다,발산하다
unclaimed - 소유불명의
without adoubt - 의심할바없이
affix - 첨부하다,붙이다
almost - 거의,대체로
altruism - 이타주의
analysis - 분석
analyst - 분석가
analyze - 분석하다
around the world - 전세계에
be comparable to - ~에필적하다
be compatible with - ~와양립하다
comment - 논평,해설,의견
commerce - 상업,무역
comefrom - ~에서발생하다
complie - 편찬하다,편집하다
complain - 불평하다
complaint - 불평,불만
describe - 묘사하다,설명하다
description - (제품등의)설명서,해설
entitle - 자격을주다
equip - 갖추다
equipment - 장비,설비(=apparatus)
follow - 따르다,이해하다
for free - 무료로
form - 형식,양식
formal - 형식적인,정식의
formality - 의례적행위,(복수형)정규절차
formalize - 형식(공식)화하다
formally - 정식으로,공식으로
formalness - 형식적인것
formation - 구조,형태
herein - 이러한이유로
infusion - 주입,고취
ingredient - (혼합물의)성분,재료
jeopardize - 위태롭게하다,위험
logic - 논리,논리학
luggage - 짐,수화물(=baggage)
momentum - 추진력,힘
necessarily - 반드시
necessary - 필요한,필수적인
necessitate - 수반하다,필요로하다
necessity - 필수품,필요성
note - 주목하다,유의하다
order - 주문하다
organize - 조직하다,체계화하다
outcome - 결과
personal - 개인의
personality - 개성,성격
personalize - 이름을표시하다
personally - 개인적으로
plenty - 풍부,다량
plenty of~ - 풍부한,많은
point - 요점,특징
policy - 정책,방침
predict - 예칙하다,예보하다
prediction - 예언,예보
pretty - 꽤,매우
priorto - ~이전에,~앞에
public - 공공의,대중의
regular - 정규의,규칙적인
regularity - 규칙성
regularly - 규칙적으로,정기적으로
reject - 거절하다
sharp - 예리한,급격한
short - 모자라는,부족한
shorten - 줄이다,삭감하다
shortly - 곧
show - 전시회,표시,상영(분)
suddenly - 갑자기
total - 전체의,총계의
uncommon - 보기드문,비범한
use - 사용하다,쓰다
used - 중고의
usefulness - 유용성,실용성
user - 소비자,사용자(=utilizer)
alert - 경고하다
apart - 떨어져
apparatus - 기구,장치
apparel - 의복
appearance - 외관,모양
asidefrom - ~를제외하고는
be concerned about - ~을 의식하고있다
be conscious of - ~을 의식하고있다
commission - 수수료,위원회
commit - 위탁하다,맡기다
commitment - 공약,약속
committee - 위원회
complete - 완성하다,끝내다
completely - 완전히
completeness - 완전함,철저함
completion - 완성,완료
concede - 인정하다,시인하다
design - 고안하다,기획하다
designated - 지정된,배정된
designed - 계획적인,디자인된
destroy - 파괴하다
direct 사람 to 장소 - (사람을장소로)안내하다
discouragement - 낙담,낙심
eligible - 자격이있는,적격의
embarrassing - 난처하게하는
escalate - 점차확대하다
escalation - (단계적)확대,증대
escalator - 에스컬레이터
final - 최종적인,마지막의
finalize - 완성하다,끝내다
finally - 마침내,결국
forfeit - 몰수당하다
forfeiture - 몰수,과금
hesitantly - 주저하며,망설이며
hesitate - 망설이다,머뭇거리다
hesitation - 주저,망설임
improper - 부적절한
inaccurate - 부정확한
inhalation - 흡입(제)
inhale - 흡입하다,들이쉬다
inhibition - 금지,억제
join - 결합하다,참가하다,가입하다
legible - 읽기쉬운
liable - 자칫하면~하는,책임져야할
livebroadcast - 생방송
merge - 합병하다
orientate - (환경에)적응시키다
pollutant - 오염물질,오염원
pollute - 오염시키다
polluted - 오염된
pollution - 오염,공해
post - 게시하다
regulate - 조절하다,단속하다
regulation - 규정,단속
regulatory - 조절하는,규제하는
relay - 교체자를 준비하다
relevance - 적절,관련성
reliability - 신뢰성,신빙성
reliable - 믿을수있는
reliably - 신뢰할수있게
reliance - 신뢰,신임
relyon - ~에 의존하다
routinely - 일상적으로
sight - 경치,구경거리
sign - 징조,표시
signed - 서명된
speculate - 숙고하다,추측하다
speculation - 사색,투기
speculative - 추측의,투기의
standin for - ~를대리하다,대신하다
tanks to - ~의 덕택으로
transport - 운송하다,전달하다
transportable - 수송(운송)할수있는
transportation - 운송,수송기관
adequately - 적절하게,알맞게
allow - 허용하다,수락하다
allowance - 수당,허용
alter - 바꾸다,고치다
annual - 해마다의,1년의
approach - 접근법,입구
appropriately - 적절하게,적당히
be dedicated to - ~에 헌신하다
be dividedin to - ~로 분할되다
bring - 가져오다,초래하다
cometoanend - 끝나다
conclude - 결론을내다
conclusion - 결론
conclusive - 결정적인
conclusively - 단호하게,결정적으로
correctly - 정확하게
deteriorate - 나쁘게하다,타락시키다
detract - (주의를)돌리다
distraction - 산만하게하는것,기분전환
evident - 명백한,뚜렷한
evidential - 증거에근거한
evidently - 명백하게,분명히
evidence - 증거,증명
examine - 검사하다,조사하다
example - 사례,견본
forward - 앞에,앞으로
forwarding - 발송
in conjunction with - ~와함께
incontrast - 대조적으로,반대로
insist - 주장하다
inspect - 시찰하다,검사하다
interest in - ~에 대한관심
introduce - 소개하다,도입하다
introduction - 소개,도입
justify - 정당화하다
light - 가벼운
likeable - 마음에드는
look for - ~을 찾다
look into - ~을 조사하다
lookover - (서류등을)검토하다,훑어보다
minimal - 최소한의
minimally - 극미하게,최소한으로
minimize - 극소화하다
minimum - 최소,최저
missing - 빠진,분실한
modify - 수정하다,변경하다
morale - 사기,의욕
nevertheless - 그럼에도불구하고
outdated - 구식의,시대에뒤쳐진
outstanding - 눈에띄는,미결제의
overbear - 압도하다,우세하다
overcome - 극복하다,이기다
petty - (금액이)적은,시시한
plain - 명료한,평이한
poor - 불충분한,뒤떨어진
poorly - 서투르게,부족하게
practice - 실행,업무
preamble - 머리말
precept - 지시,취급규칙
prefer - 선호하다,우선하다
preferably - 되도록이면
preference - 선호,기호
profess - 공언하다,단언하다
profession - 직업
professional - 전문적인
professionalism - 전문가기질,프로근성
professionally - 전문적으로
proper - 적절한,알맞은
reachsolutions - 결론에이르다
reluctant - 마지못해하는
remote - 멀리 떨어진
report - 보고서,보고하다
secondaryeffect - 부차적인영향
slowdown - 경기후퇴
state - 진술하다,명시하다
travel - 여행하다,이동하다
anxious - 걱정하는,열망하는
approval - 승인,동의
approve - 승인하다,찬성하다
approved - 인가된,공인된
approvingly - 찬성하면서
be equipped with - ~를 갖추다
be faced with - ~와 직면하다
complex - 복합빌딩
compliance - 응낙,수락
compliment - 찬사,경의
complimentary - 무료의,칭찬의
component - 구성요소,성분(=part)
conduct - 실시하다
confide - 신뢰하다
confidence - 신뢰
confident - 확신하고있는
confidential - 기밀의
develop - 발전시키다,개발하다
developer - 개발자
developing - 개발도상의
development - 발전,개발
exceed - 초과하다
exclude - 제외하다,배제하다
exclusion - 제외,추방
exclusively - 배타적으로,독점적으로
exclusiveness - 배제,독점
exclusivity - 독점
foster - 육성하다,촉진하다
fragment - 부서진조각,파편
in comparison with - ~와 비교하여
in compliance with+규정 - (규정에)따라
instigate - 유발시키다,조장하다
instrument - 기구,수단(=apparatus)
interest - 관심,이자
interested - 흥미있어하는
interesting - 흥미있는
kindly - 친절하게,기꺼이,부디
lookforward to + 명사 - ~을 고대하다
motion - 동작,움직임
nicely - 훌륭하게,잘
overdrawn - 초과인출한
overexpose - 지나치게 노출하다
pleasant - 즐거운
please - 기쁘게하다,만족시키다
pleased - 기쁜,만족한
pleasurable - 즐거운
pleasure - 기쁨
premium - 보험료
preside - (회의의)의장을맡아보다
press - 누르다,압박하다
pressure - 압력
renew - 갱신하다,새롭게하다
renewal - 재개,갱신
repeated - 되풀이된
repeatedly - 되풀이하여
repetition - 반복,되풀이
repetitiously - 반복해서
revise - 개정하다,수정하다
revision - 수정,개정
seldom - 좀처럼~않는,드물게
simple - 단순한
simplicity - 간단,평이
simplify - 간단하게하다,단순화하다
simply - 간단히,오직
slight - 약간의,근소한
slightly - 조금,약간
slightness - 미량,조금
spectator - 구경꾼,관객
staff - 직원,사원
stage - 무대,단계
stimulate - 자극하다,격려하다
stir - 휘젓다,뒤섞다
taxon - (물건)에의세금
undecided - 결정되지않은
advocate of - ~의 옹호자
annex - 부가하다,합병하다,부속건물
aptitude - 재능,적성
arbitration - 중재,조정
arbitrator - 중재자,조정자
assist with - ~에 대해돕다
be full of - ~로가득한,가득찬
be happy with - ~에 대해 행복해하다
be ideal for - ~에이상적이다
concur - (의견이)일치하다
concurrence - 의견일치,동의
concurrent - 동시발생의
concurrently - 동시에
confirm - 확인하다
confirmation - 확인
confirmed - 확인된
conform - (법,바람등에)따르다
contact - 접촉,연락하는사람
diagnose - 진단하다
diagnosis - 진단
diagnostic - 진단상의
diagnostically - 진단상으로
enlightening - 계몽적인,깨우쳐주는
execute - 성취하다,실행하다
exile - 추방,망명
expand into - ~로확장하다
fixed - 고정된,확고한
frequency - 빈번,빈도
frequent - 빈번한
frequently - 자주
huge - 거대한,커다란
hugely - 크게,매우
implicate - 연루시키다,관련시키다
implication - 함축,내포
indetail - 상세하게
incomparable - 비교할수없는
incompetent - 무능한
ineffect - (법률등이)유효한
institute - 세우다,설립하다
instruct - 가르치다,지시하다
instruction - 지시,교육
knowledge - 지식
monitor - 감시하다,감독하다
monotone - 단조로운
mounting - 상승하는,증가하는
overall - 전부의,총체적인
overdue - 지불 기한을 넘긴
overlap - 겹치다,중복되다
overlay - 씌우다
premonition - 전조,예감
preparation - 준비
prepare - 준비하다
prevent - 막다,방해하다
preventable - 막을수있는
prevention - 예방,저지
preventively - 예방적으로
price - 값을매기다
prosperity - 번영
receipt - 영수증
receive - 받다,수령하다
received - 받아들여진,용인된
renovate - 수리하다,새롭게하다
renovation - 개혁,수리
rent - (차량·집등을)빌리다
reservation - 예약
reserve - 비축하다
reserved - 예약된
resolution - 결의,해결
separately - 개별적으로
separation - 분리,분할
stamp - 우표
standard - 표준,기준
statement - 보고서,명세서
streamline - 능률적으로하다
thereafter - 그이후에
work extended hours - 연장근무하다
allergic reaction - 알레르기반응
anticipate - 예상하다,기대하다
apologize - 사과하다
appeal - 호소하다
architect - 건축가
area - 범위,지역
arena - 경기장
be incharge of - ~를 맡고있다,~를 담당하다
be interested in - ~에흥미가있다
be involved in - ~에 종사하다,~와 관련하다
busy telephonelines - 통화중인전화
coming - 다가오는
comply with+규칙 - (규칙)을따르다,준수하다
confront - 직면하다
confuse - 혼란시키다
confusion - 혼돈
connection - 연결,관계
conquest - 정복
conserve - 보존하다,보호하다
differ - 차이가나다,다르다
difference - 차이
different - 다른
differently - 다르게
dilute - 묽게하다,희석하다
entire - 전체의,완전한
entirely - 완전히
exhibit - 전시하다,나타내다(=display)
existence - 존재,실재
existing - 현재의,기존의
expand - 넓히다,확장시키다
expanse - 광활한 공간
expansion - 확장
expansive - 넓은,포괄적인
go through - (어려움등을)겪다
have no idea - 모른다
hurt - 다치게하다,상하게하다
immediately - 즉시,곧
inending - 끝으로
intend - ~할작정이다,의도하다
intensify - 증대하다
intensive - 강한,철저한
interviewer - 면접관
international flight - 국제선
live - 생방송인,실황의
manage - 경영하다,관리하다(=handle)
manageable - 다룰수있는,처리하기쉬운
management - 경영,관리
manager - 지배인,경영자
managing - 경영하는
monopolize - 독점하다
monopoly - 독점
overhead - 머리위의
overpower - 이기다,압도하다
overprice - 값을너무높게매기다
polite - 공손한,예의바른
politely - 공손하게
politeness - 공손함
president - 사장,은행장
print - 인쇄하다,출판하다
proceed - 계속하다,나아가다
proceeding - 행동,소송
procrastinate - 꾸물거리다
repairable - 보수가가능한
repair - 수선하다,수리하다
resource - 자원
resourceful - 자원이풍부한
seriously - 진지하게
speak - 이야기하다,연설하다
step - 단계,조치
stratagem - 전략,책략
strategic - 전략의
strategical - 전략의,전략상의
strategically - 전략적으로
strategist - 전략가
strategize - 전략을짜다,빈틈없이계획하다
strategy - 전략,방법
thickly - 두껍게,짙게
appear - ~인듯보이다,나타나다
appoint - 지명하다,임명하다(=name)
arrival - 도착
aspiration - 포부,목표
backward - 뒤로,거꾸로
be irrelevant to - ~와무관하다
beknownfor - ~로알려지다
concentrateon - ~에집중하다
console - 위로하다
consolidate - 강화하다,합치다
consolidation - 합병,강화
consolidator - 통합자
designated area - 지정된지역
direct - 지시하다,가리키다
direction - 명령,지시
directive - 지시하는
directly - 즉시,곧바로
director - 관리자,중역
disallow - 허가하지않다,인정치않다
expect - 기대하다,예상하다
expectancy - 예상,기대
expectant - 기대하는,기다리는
expectantly - 기대하며,예상하여
expectation - 기대,예상,가능성
expected - 예기된,기대된
expedite - 신속히처리하다
fume - 연기,김
function - 연회,행사,기능
furniture - 가구
give a speech - 연설하다
incorrect - 부정확한,틀린
inerror - 실수로
inexcessof - ~을 초과하여
interpret - 해석하다,설명하다
interpretation - 해석,통역
interpreter - 통역가
invention - 발명,고안
loath - 싫어하는
local - 지역의
locale - 현장,장소
locality - 장소
localize - (위치를)정확히찾다,국한하다
localization - 국한
locally - 지역적으로
maturity - 성숙,원숙
onthewane - 쇠퇴하기시작하여
popular - 인기있는,대중의
produce - 생산하다
producer - 제작자,생산자
producible - 생산할수있는
product - 제품,상품
production - 생산,제작
productive - 생산적인
productively - 생산적으로
productivity - 생산성
prudent - 신중한,조심성있는
replace - 대신하다,교환하다
reply - 대답하다
responsibility - 책임,의무
responsible - 책임이있는
responsibly - 책임감있게
result - 결과,결과로서생기다
severely - 심하게,엄격하게
some what - 얼마간,다소
strike - 파업하다
striking - 눈에띄는,인상적인
struggle - 애쓰다,분투하다
study - 연구,조사,연구하다
subject - 주제,당하게하다
subjection - 복종,종속
unexpected - 예상치못한
unfair - 불공평한,부당한
unfairly - 부당하게,불공평하게
unfairness - 불공평함,부당함
visual - 시각의,눈에보이는
annotated - 주석이달린
appreciate - 가치를인정하다,감상하다
appreciation - 감사,감상
approximate - 접근하다,가까워지다
approximately - 대략
approximation - 접근,근사
asset - 자산
assimilation - 동화,융합
be for ehand - 미리,앞질러
be liable to+동사원형 - ~할것같다
be made of - ~로 만들어지다
be noted for - ~로 유명하다
comparable - 필적하는
compare - 비교하다
comparison - 비교
compatible - 양립할수있는
construct - 건설하다
construction - 건설
constructive - 건설적인
constructor - 건설자
consult - 상담하다
consultant - 컨설턴트,상담고문
container - 용기,컨테이너
contentment - 만족
contest - 시합,논쟁
contestant - 출전자,경쟁자
dependent - 의존하는
disappoint - 실망시키다
disappointed - 실망한
disappointing - 실망시키는,시시한
disappointment - 실망,낙담
disband - 해산하다
discharge - 내보내다,이행하다
durability - 내구성,내구력
durable - 내구력이있는
duration - 지속기간
equal - 같은,동등한
equally - 동등하게,평등하게
equivalent - 동등한,상당하는
expend - 소비하다
expenditure - 지출,소비
experience - 경험,이력
experienced - 경험이있는,노련한
incidental expenses - 잡비
invalidate - 무효로하다
in good condition - 상태가좋은,건강한
marketingon - (물건)에대한마케팅
motivate - 동기를주다,자극하다
motivation - 동기부여,자극
near - ~에 가깝게
nearly - 거의
nearness - 근접함,가까움
observably - 식별할수있게
observance - 준수,엄수
observant - 주의깊은,엄수하는
observantly - 주의깊게
observation - 관찰
observatory - 관측소,천문대
observe - 준수하다,관찰하다
oversee - 감독하다
proliferate - 증가하다,번식시키다
properly - 적절하게,알맞게
reproduce - 재생하다,복사하다
repulse - 혐오감을주다,거절하다
repulsion - 반박,거절
request - 요청하다
respondto - ~에응답하다
retirement - 은퇴,퇴직
reunion - 재결합
subscriber - 구독자
subscription - 예약구독
succeed - 성공하다,계승하다
success - 성공
successful - 성공적인
successfully - 성공적으로
successive - 연속하는,잇따르는
arise - 일어나다,발생하다
arrange - 계획하다,준비하다
atrium - 중항홀,안뜰
attempt - 시도 - 시도하다
be latedly - 뒤늦게
be opposite to - ~에 반대되다
be related to - ~에관련되다
consume - 소비하다
consumer - 소비자
consumption - 소비
contend - 주장하다
convenience - 편의,편리
convenient - 편리한
conveniently - 편리하게
convention - 사회의관습,풍습
convergence - 한점에의집중,수렴
disclose - 드러내다,폭로하다(=reveal)
discontinue - 그만두다,중지하다
discount - 할인하다 - 할인
draft - 초고,초안
experiment - 실험
expertise - 전문적 기술
expiration - 만료,종결
expire - 만기가되다,끝나다(=lapse)
expired - 기간이 만료된
explain - 설명하다
extraneously - 외부적으로,관계없이
for eseeable - 예측할수있는
impress - 깊은인상을주다,감동시키다(=touch)
impressed - 감동한
impressive - 인상적인,감명깊은
impressively - 인상적으로
incredible - 놀라운,믿어지지않는
incredibly - 놀랍게
inhonorof - ~에 경의를표하여
initial - 처음의,머리글자를쓰다
initially - 처음에,시초에
initiate - 시작하다
issue - 문제,논제
once - ~하는대로
owe - 빚지다,신세를지다
personal belongings - 개인소지품
premier - 최고의 - 수상,주지사
profusion - 풍부
progress - 진행
progression - 발달,전진
progressive - 전진하는,진보하는
proof - 증거
readily available - 쉽게 이용할수있는
require - 요구하다,필요로하다
required - 필수의
requirement - 요구조건,필요조건(=prerequisite)
requisition - 요구,요청,청구서
research - 조사하다,연구하다
researcher - 연구원,조사자
resent - 분개하다,원망하다
revenue - 세입,수익
reward - 보상,보답
run down - 지친
special - 특별한
specialist - 전문가
specialize - 전문적으로하다
specially - 특별히
steep - 가파른,급격한
steeply - 가파르게,급격하게
suffice - 충분하다,족하다
sufficiency - 충분,충족
sufficient - 충분한
sufficiently - 충분히
sum - 총계,합계
summarize - 요약하다,개괄하다
summary - 요약,개요
think about - ~에 대해생각하다
think of - ~를 생각하다
timelessly - 영원히,무한히
assail - 공격하다
assemble - 모으다,조립하다
assembled - 모인,결집한
assembly - (기계의)조립,집회,의회
attire - 옷차림,의복
average - 평균 - 평균의,보통의
below - ~아래에,~이하
be responsible for - ~에반응하다
be responsive to - ~에반응하다
contract - 수축하다,계약하다
contraction - 단축,축소
control - 통제하다,관리하다
convene - (회의를)소집하다
copy - 사본,권,부
corporation - 법인,주식회사
corrosion - 부식작용,침식
cost - 비용,비용이들다
discover - 발견하다
discriminate - 구별하다,식별하다
discuss - 논의하다
discussion - 토론,논의
disengage - 연결을풀다,놓아주다
duty - 의무,직무
elevate - 올리다,승진시키다
elevation - 높이높임,승진
expose - 노출하다,드러내다
exposure - 드러냄,폭로
extremely - 극단적으로,매우
former - 이전의,전자의
head for - ~을 향하다
independent - 독자적인,독립한
in light of - ~의견지에서,~에비추어보아
in observance of - ~를준수하여
invite - 초대하다,초청하다
involve - 포함하다,수반하다
involved - 관련된
involvement - 관련
move - 이동하다,이주하다
outside - ~밖으로
paid - 유급의
proposal - 제안,계획
propose - 제안하다(=suggest)
proposition - 제안,제의
prospect - 전망,예상
prospective - 장래의,지망의유망한
prosper - 번영하다
prosperity - 번영
prosperous - 번영하는
prosperously - 부유하게
protect - 보호하다
protection - 보호
protective - 보호하는
resist - 저항하다,맞서다
respectable - 존경할만한
respect - 존경하다,존중하다
respectful - 존중하는
respectfully - 공손하게,정중하게
right - 옳은,알맞은
rightful - 올바른,정당한
rightfully - 올바르게,정당하게
rightly - 정확히,바르게
risk - 손해,위험
rival - 경쟁자
serve - 대접하다,섬기다
service - 손님시중,서비스
serviceable - 유용한
suggest - 제안하다,암시하다
suggestion - 제안
supervision - 감독,관리
supplement - 보충하다 - 부록,추가
supply - 공급하다
time constraints - 시간제한
triple - 3중의,3배의
unknown - 알려지지않은
unlimited - 끝없는,제한없는
uponrequest - 요청시에
admission - 입장(허가),입장료
admit - 인정하다,허가하다
ambivalence - 반대감정병존,동요
apprehensive - 우려하는,염려하는
assert - 단언하다,주장하다
assign - 할당하다,명하다
assignment - 할당,과제
assist - 돕다
be restored to - ~로복구되다
be subject to - (당)하기쉽다
blandly - 부드럽게
bowl - 사발
card - 카드,명함
complacent - 자기만족의
confidence in - ~에의 자신감
conscious of - ~에대해 인식하고있다
conversion - 변화,전환
convert - 전환하다
convey - 운반하다,전달하다
cooperate - 협력하다
cooperation - 협동
cooperative - 협력적인
cooperatively - 협력하여,함께
customer - 고객
customization - 설정변경
customize - 개인의취향에맞춰변경하다
densely - 조밀하게
deposit - 예치금 - 예금하다
determined - 결연한,단호한
dislocate - 어긋나게하다,탈구시키다
dismiss - 해고하다
dispatch - 급파하다
displace - 교체하다,쫓아내다
enlarge - 확장하다
exact - 정확한,정밀한
exacting - 엄격한,힘든
exactly - 정확히,똑같이
exactness - 정확함
extra - 추가의,여분의
faculty - 능력,재능
fairly - 꽤,공정히
frenetic - 열광적인,흥분한
indifference - 무관심
inparticular - 특히
leave - 떠나다 - 휴가
moveaway - 물러가다
obstacle - 장애물,방해물
officially - 공식적으로
out of print - 절판되어
own - 소유하다
owner - 소유자
ownership - 소유권
participant - 참가자
participate - 참가하다
participation - 참가,관여
premeditate - 미리계획하다
presumably - 아마
presumptive - 추정의
procedural - 절차상의
procedure - 진행,절차
protest - 이의를제기하다,항의하다
prove - 증명하다,입증하다
resonate - 반항하다,울려퍼지다
respond - 대답하다,응답하다
respondent - 응답자
response - 응답,반응
simultaneously - 동시에
stress - 강조,압박
structure - 구조,체계
tension - 긴장,압력
term - 기간,조건
try - 시도하다,노력하다
uniquely - 특이하게,독특하게
upstart - 거만한사람
attach - 부착하다,첨부하다
attached - 부착한,첨부한
behavior - 행동,태도
be superior to - ~보다뛰어나다
briefly - 간단히
coordinate - 조정하다,조화시키다
coordination - 조정,조화
correlate - 서로관련시키다
counsel - 상담 - 조언하다(=advise)
detail - 세부,세목
detailed - 상세한,자세한
disputeover - ~에대한분쟁
disrupt - 중단시키다,혼란에빠뜨리다
dissatisfy - 불만을느끼게하다
distribute - 분배하다,배치하다
distributed - 분포된
distribution - 분배,유통
distributor - 유통업자,유통업체
exportation - 수출,수출품
express - 표현하다,나타내다
expression - 표현
expressive - 표현하는,표정이풍부한
fondness - 애호,아주좋아함
glance - 흘끗봄
growthrate - 성장률
hospitality - 환대,접대
incentive - 자극,동기
indefinitely - 무기한으로
individual - 개개의
individualism - 개인주의
individualist - 개인주의자
individuality - 개성
individually - 개별적으로,개인적으로
inplaceof - ~를대신하여
inspiteof - ~에도불구하고
internment - 억류,수용
limitation - 한계,제한
limited - 제한된,한정된
maximum - 최대
multiply - 증가시키다,곱하다
presumptuous - 주제넘는,건방진
prevalent - 유행하는,널리펴진
previous - 이전의
previously - 예전에,이전에
provide - 공급하다,제공하다
provided - 만약,~라면
providing - 만약,~라면
provision - 준비,식량
publish - 출판하다
responsive - 반응이빠른
responsiveness - 민감,반응성
restore - 복구하다,회복하다
restrained - 자제된,삼가는
restructure - 개조하다,개혁하다
return A to B - A를 B에 돌려주다,반납하다
signifier - (개념또는의미의)상징,소리,이미지
signify - 나타내다,암시하다
sincerely - 진심으로
sticky - 끈적끈적한
substantial - 상당한
substantiality - 실재성,실질성
substantially - 상당히
substantiate - 증명하다
submit A to B - A를 B에 제출하다
support - 지원하다,지지하다
tour - 여행
turn - 돌리다
unoccupied - (건물이)비어있는(=vacant)
unrecoverable - 되찾을수없는,회복불능의
unusually - 현저하게,유별나게
venture - 모험적사업
venturesome - 모험을좋아하는
advertisement - 광고
attend - 참석하다
attendee - 참석자
becauseof - ~때문에
benefit from - ~에서 이익을얻다
brightly - 밝게,선명하게
circumstance - 상황,환경
collection - 수집,소장품
collective - 축적된,공동의
collector - 수집가
condensed - 간결한,압축된
consistof - ~로이루어져있다
correspond - 상응하다
correspondence - 일치,상응,연락
corresponding - 상응하는
correspondingly - 상응하여
create - 창조하다,발생시키다
creation - 창조,창작
creative - 창조적인,독창적인
creatively - 창조적으로,독창적으로
creativeness - 창조적임,독창성
creativity - 창조성,독창성
dealing - 거래
decadence - 쇠퇴,타락
disturb - 방해하다
disturbance - 소란,동요
disturbing - 불안하게하는
divest - 빼앗다,박탈하다
excellent - 뛰어난(=preeminent)
excessive - 과도한
experimentwith - ~을실험하다
extend - (크기·위치가~에)달하다
extended - 연장된
extension - 연장,확장,내선(번호)
extensive - 광범위한,포괄적인
extensively - 널리,광범위하게
fine - 벌금,과태료
finely - 정교하게
firm - 회사 - 확고한
firmly - 단단하게,견고하게
fresh - 신선한,새로운
freshen - 새롭게하다
freshly - 신선하게
freshness - 신선미,생생함
full - 가득찬,충실한
fully - 완전히,충분히
increment - 증가,증대
inspiration - 영감
install - 설치하다
installation - 설치
insubordinate - 반항하는,복정하지않는
insummary - 요약하여
intention - 의도,목적
inthepast - 과거에
manufacturer - 제조업자
maximum security - 최대한의 보안
origin - 기원
original - 독창적인,원작의
originality - 독창성
originally - 시작하다,일으키다
possible - 가능한,있음직한
purchase - 사다,구입하다
purchased - 산,구매된
question - 질문,의문
refund - 환불하다
return - 반환하다,회답하다
returned - 반송된,돌아온
reveal - 드러내다,폭로하다
revelation - 폭로,적발
review - 재조사하다,재검토하다
site - 부지,장소
stare - 응시하다
struck - 동맹파업으로폐쇄중인
suppress - 억압하다
arguable - 논쟁의여지가있는
argument - 논쟁
argumentative - 논쟁적인,논란을일으키는
automate - 자동화하다
automatically - 자동적으로
avert - (사고·위험을)막다
avoid - 피하다,막다
award - 수여하다 - 상
cancel - 취소하다
cancellation - 취소
commencement - 개시,시작
condition - 상태,조건
conditional - 조건부의
count - 세다,계산하다
countdown - 카운트다운
curb - 억제하다(=restrain)
difficulty - 어려움,곤경
dissentingly - 반대하여,이의를제기하여
divide - 나누다,분리하다
divided - 분리된,분배된
dividend - 배당금(=allotment)
division - (회사의)부서,분할
drop - 떨어지다,하락하다
empathic - 감정이입의,공감할수있는
environmental - 환경의
environmentalism - 환경보호주의
environmentalist - 환경보호론자
environmentally - 환경보호적으로
exertion - 노력,힘든운동
feedback - 피드백,반응,의견
further - 그이상의,한층더한
furthermore - 더욱이,게다가
inherently - 본질적으로,근본적으로
intact - 손상되지않은
intheory - 이론상
inwriting - 서면으로,문서로
majority - 다수,대다수
member - 회원,구성
outoftheoffice - 부재중인
personalcheck - 개인수표
position - 직위,지위
precipitation - 강수량
pursue - 추구하다,수행하다
pursuit - 추구,수행
quite - 꽤
rather - 오히려,다소
relic - 유적,유물
respectforphr,~에대한존경
revolve - 회전하다,순환하다
rise - 승진하다,오르다(=increase)
significance - 중요성,의미
significant - 상당한,중요한
significantly - 상당히,두드러지게
slowly - 천천히,느리게
subjective - 주관적인
subjectively - 주관적으로
succeedin ~ing - ~에 성공하다
surround - 둘러싸다
surrounding - 주의의
suspend - 보류하다,미루다
swap - 바꾸다,교환하다
taste - 맛보다 - 맛
type - 종류,양식
vaguely - 모호하게
vapor - 증기
variation - 변화,변동
varied - 가지각색의
variety - 종류,다양(성)
variously - 다양하게
vary - 다르다,바뀌다
amalgamate - 합병하다
amaze - 놀라게하다
amazed - 놀란
amazement - 깜짝놀람,경악
amazing - 놀라운
apportionment - 분배,할당
ascertain - 확인하다,규명하다
bear - 견디다,지니다
bill - (계산서로)청구하다
bring - 사물
toahalt - (사물을)정지시키다
bytelephone - 전화로
byhand - 손으로
capitalize - 자본화하다,투자하다
capture - 획득하다,점유하다
contendwith - ~와경쟁하다
courteous - 예의바른
courteously - 정중하게,친절하게
courteousness - 예의바름
courtesy - 예의
customs - 관세,세관
customarily - 습관적으로,관례상으로
customary - 습관적인,통상적인
demonstrate - 설명하다,증명하다(=prove)
detect - 찾아내다,감지하다
distantly - 멀리서
distinct - 독특한,뚜렷한
distinction - 구별,차이
distinctive - 특유의
distinctively - 독특하게
donate - 기부하다
donation - 기부,기증
dueto - ~때문에
expense - 지출,비용
expensive - 비싼
expensively - 비싸게
expensiveness - 물건이비쌈
extinction - 멸종
flex - 구부리다,수축시키다
flexibility - 유연성,융통성
flexible - 유연한
industry - 산업
influence - 영향 - 영향을주다
insert A into B - A를 B에 삽입하다
invest - 투자하다
investment - 투자
investor - 투자가
investigation - 조사,수사
lead - (어떤결과에)이르게하다
outweigh - 능가하다
overly - 지나치게,몹시
override - 우위에서다
primal - 본래의,주요한
primarily - 주로,우선적으로
primary - 주요한,기본적인
prime - 주된
principal - 주요한
proximity - 근접,접근
readily - 쉽게,즉시
ready - 준비된
removal - 제거
remove - 제거하다
repeal - 무효로하다,취소하다
restricted - 제한된,한정된
revolutionary - 혁신적인
rich - 풍부한,(~이)많은
softly - 부드럽게
staffproductivity - 직원생산성
submit - 제출하다
throughouttheday - 하루종일내내
unsafe - 위험한,안전하지못한
unstable - 불안정한
ventilation - 통풍,환기
where abouts - 소재,행방
appraisal - 평가,견적
associated - 관련된
assorted - 여러가지를한데모은
assurance - 보증,확신
assure - 보증하다,확신하다
by meansof - ~에의하여
by nomeans - ,결코~아니다
catch - 잡다,추적하다
consecutive - 연속적인
consensus - 합의,여론
consent - 동의,허가
consentof - (사람)의동의
consistent - 일치하는
consistently - 지속적으로,일관되게
device - 장치(=gadget),방책
devise - 고안하다
do business with - ~와거래하다
effect - 결과,영향
effective - 효과적인
effectively - 효과적으로
effectiveness - 유효성,효과적임
excitable - 흥분을잘하는
excite - 흥분시키다,자극하다
excited - 흥분한,들뜬
excitedly - 흥분하여
excitement - 흥분,동요
exciting - 흥분시키는,재미있는
face - 직면하다
guarantee of - ~에대한보증
induce - 야기시키다,권유하다
inflate - 인상하다,오르다
inflated - 팽창한,폭등한
inflation - 인플레이션,물가상승
injured - 상처입은,다친
insincerely - 성의없게
insteadof - ~대신에
integrate - 통합하다
interfere - 방해하다,간섭하다
open - 열다,개방하다 - 공개된,열린
opening - 결원,공석
overload - 짐을너무많이싣다
owingto - ~때문에,~로인한
persuadable - 설득할수있는
persuade - 설득하다
persuasion - 설득
persuasive - 설득할수있는
persuasively - 설득력있게
precaution - 예방책
preserve - 보호하다,지키다
prize - 상
probability - 가능성
purpose - 목적,취지
reduce - 감소시키다,감소하다
reduction - 축소,삭감
reductive - (설명을)축소하는
register - 등록하다
renegotiate - 재교섭하다
runshort - 부족하다
space - 공간 - 일정한간격을두다
spacious - 넓은(=roomy)
spread - 보급시키다,펼치다
stability - 안정성
stable - 안정된
stay - 머무르다 - 체류
touchdown - (비행기가)착륙하다
treat - 취급하다,간주하다
undergo - 겪다,경험하다
voluntarily - 자발적으로
voluntary - 자발적인
volunteer - 지원자
warranty - 보증
wash - 씻다,세탁하다
whereas - 반면에
affect - 영향을미치다
affection - 애정,호의
attract - 유치하다,끌다
attraction - 매력,(관광)명소
authorization - 공인,허가
authorize - 권한을부여하다,허가하다
authorized - 공인된,인가된
authorship - 원작자
available - 이용가능한,사용할수있는
bywayof - ~의방법으로,~에의해서
challenge - 도전하다
challenging - 도전적인
configuration - 배치,형태
contingent - ~를조건으로하는
contribute - 기부하다
contribution - 기부,분담금
contributor - 기부자
cover - 감당하다,보험에들다
coverage - (보험의)보상범위
cutback - 줄이다,삭감하다
cultivate - 경작하다
cultivation - 경작,양성
diverse - 다양한
diversification - 다양성,변화
diversified - 다양한
diversify - 다각화하다,변화시키다
diversity - 다양성
edit - 편집하다
edition - 판,부수
editor - 편집장,교정자
encounter - 우연히 만나다
engage - 종사하다,관여시키다
engineer - 기술자
estimate - 견적,평가
estimated - 견적의,어림의
estimation - 평가,견적
exercise - 운동
facilitate - 촉진하다,용이하게하다
facilitation - 촉진
facilitator - 촉진자,용이하게하는사람(것)
facility - 시설,설비
fleetly - 신속하게,빨리
formnow - 지금부터,이제부터
grasp - (단단히)붙잡다,이해하다
hold - 소유하다,수용하다
implant - 주입하다,이식하다
inform - 알리다(=notify)
informative - 유익한,정보를주는
informatively - 유익하게
informed - 정보에근거한,유식한
informeddecision - 정보에근거한결정(판단)
innovative - 혁신적인
inordinate - 지나친,과도한
instantly - 즉시
interfere - ~을방해하다
offend - 위반하다
particularly - 특히
possess - 소유하다,지니다
problemwith - ~에관련된문제점
profile - 프로필
profit - 이익,이윤
profitable - 유익한
profiteer - 부당이득자
project - 사업,프로젝트
putinfor - ~에 신청하다,입후보하다
refer - 조회하다,참조하다(=consult)
reference - 참조
schedule - 일정을잡다,예정하다
segment - 조각,부분
segmentation - 구분,분할
turn down - ~를줄이다,낮추다,거절하다
widely - 넓게,일반적으로
widen - 넓히다
